111111111111
100C0000P111
111111111111
1111E1101111
111111111111
