1111111111111111111111111111111111
10E00000000000000000000000000010C1
101100010010000010100100C00C010101
1010010011101010001001000000010101
100000000001000000000P00CC0CCCCC01
1111111111111111111111111111111111
