1111111111
11C00E0011
1100000011
1100P00111
1000000011
1111111111
